1	CLARINEX	24	13	11	'Pancreatitis acute, Ventricular fibrillation, Dermatitis bullous'
2	UROXATRAL	21	12	9	'Hepatitis acute, Sudden death, Agranulocytosis'
6	PLAVIX	63	19	44	'Haemolytic anaemia, Sudden death, Blindness transient'
9	SANDIMMUNE	62	41	21	'Haemolytic anaemia, Respiratory failure, Aplastic anaemia'
10	PRISTIQ	9	7	2	'Coeliac disease, Glaucoma, Anger'
13	CYMBALTA	35	10	25	'Hepatitis acute, Phaeochromocytoma, Retinal detachment'
21	REVLIMID	19	1	18	'Spinal fracture, Colitis ischaemic, Renal impairment'
23	LEVAQUIN	36	11	25	'Deafness bilateral, Deafness neurosensory, Sudden hearing loss'
28	AMBIEN	37	14	23	'Hepatic encephalopathy, Neuroleptic malignant syndrome, Delirium'
29	ELOXATIN	66	45	21	'Intravascular haemolysis, Sudden death, Respiratory failure'
33	ELITEK	7	7	0	'Renal failure acute, Renal failure, Cardiac arrest'
34	REBIF	87	44	43	'Deafness transitory, Deafness unilateral, Deafness bilateral'
39	PROGRAF	27	14	13	'Liver transplant, Intravascular haemolysis, Hepatic failure'
42	AVASTIN	33	13	20	'Optic ischaemic neuropathy, Sudden death, Intestinal infarction'
44	TARCEVA	22	6	16	'Acute respiratory failure, Respiratory failure, Sudden death'
56	LO/OVRAL	3	1	2	'Hepatitis, Aspartate aminotransferase increased, Alanine aminotransferase increased'
77	ZIAGEN	63	41	22	'Pancreatitis necrotising, Hepatic necrosis, Hepatitis fulminant'
87	ADDERALL XR	13	8	5	'Self injurious behaviour, Intentional self-injury, Suicidal ideation'
104	FOSRENOL	39	21	18	'Sudden death, Pancreatitis acute, Pancreatitis'
107	TEGRETOL	70	31	39	'Aplasia pure red cell, Hepatic necrosis, Haemolytic anaemia'
109	LIALDA	2	1	1	'Respiratory failure, Chest pain'
111	DAYTRANA	7	4	3	'Accidental exposure, Mood swings, Restlessness'
112	VYVANSE	13	8	5	'Self injurious behaviour, Suicidal ideation, Intentional self-injury'
117	VIDAZA	40	26	14	'Colitis ischaemic, Respiratory failure, Pulmonary fibrosis'
135	KUVAN	8	6	2	'Nephrolithiasis, Staphylococcal infection, Anger'
147	ORENCIA	13	1	12	'Extravasation, Acute respiratory failure, Pulmonary fibrosis'
154	ABELCET	7	7	0	'Pancytopenia, Neutropenia, Coma'
156	ABILIFY	6	3	3	'Serotonin syndrome, Muscle twitching, Hallucination'
157	ZYTIGA	25	9	16	'Septic shock, Dementia, Myocardial ischaemia'
188	ACETADOTE	4	4	0	'Cardiac arrest, Infusion related reaction, Liver function test abnormal'
191	TYLENOL W/CODEINE	53	32	21	'Deafness neurosensory, Completed suicide, Hepatic necrosis'
192	VICODIN	12	2	10	'Completed suicide, Cardiac arrest, Hepatic necrosis'
193	FIORICET	3	3	0	'Completed suicide, Coma, Cardiac arrest'
194	PERCOCET	18	9	9	'Hepatic encephalopathy, Coma, Cardiac arrest'
195	ULTRACET	22	11	11	'Agranulocytosis, Pancreatitis acute, Deafness'
212	SORIATANE	19	10	9	'Renal impairment, Hepatic failure, Squamous cell carcinoma'
215	RECLAST	63	23	40	'Amyotrophic lateral sclerosis, Spinal fracture, Hip fracture'
232	AVELOX	25	8	17	'Liver transplant, Sudden death, Hepatorenal syndrome'
235	ACTIQ	9	6	3	'Completed suicide, Neoplasm malignant, Coma'
238	ACTIVELLA	1	1	0	Arrhythmia
239	ACTOPLUS MET	6	4	2	'Septic shock, Renal failure acute, Renal failure'
240	ACTOS	63	29	34	'Hepatic necrosis, Sudden death, Hepatitis fulminant'
250	ILARIS	11	5	6	'Respiratory failure, Gastrointestinal haemorrhage, Cytolytic hepatitis'
251	ACZONE	1	1	0	Swelling face
257	HUMIRA	13	5	8	'Small intestinal perforation, Intestinal perforation, Accidental exposure to product'
261	ADCIRCA	10	6	4	'Respiratory failure, Renal failure, Cardiac failure'
263	ADDERALL	19	10	9	'Serotonin syndrome, Intentional self-injury, Suicidal ideation'
278	DOXIL	36	18	18	'Pancytopenia, Acute respiratory distress syndrome, Acute respiratory failure'
279	ANDROGEL	9	6	3	'Coronary artery occlusion, Erectile dysfunction, Ejaculation disorder'
284	ADVAIR	12	2	10	'Pulmonary fibrosis, Lung neoplasm malignant, Acute respiratory failure'
289	ADVATE	1	1	0	Bacteraemia
309	AFINITOR	30	8	22	'Bone marrow failure, Renal impairment, Hepatorenal syndrome'
312	INLYTA	8	2	6	'Encephalopathy, Candida infection, Cardiac failure'
313	PREVACID	50	24	26	'Disseminated intravascular coagulation, Optic ischaemic neuropathy, Hepatic necrosis'
338	CELEXA	32	17	15	'Deafness transitory, Deafness neurosensory, Deafness bilateral'
358	COMBIVENT	6	4	2	'Lung neoplasm malignant, Hip fracture, Coronary artery occlusion'
375	ALDURAZYME	12	10	2	'Blindness, Convulsion, Cytomegalovirus infection'
376	AMEVIVE	10	2	8	'Nephrolithiasis, Dermatitis exfoliative, Respiratory failure'
386	INTRON A	32	16	16	'Liver transplant, Bone marrow failure, Hepatic necrosis'
397	ALIMTA	51	27	24	'Acute respiratory failure, Respiratory failure, Acute respiratory distress syndrome'
450	TAMBOCOR	24	15	9	'Pulmonary fibrosis, Completed suicide, Renal impairment'
451	BENICAR	41	18	23	'Hepatitis acute, Toxic epidermal necrolysis, Sudden death'
459	LOTRONEX	8	1	7	'Intestinal infarction, Acute respiratory distress syndrome, Blindness unilateral'
461	ALOXI	5	4	1	'Convulsion, Loss of consciousness, Infusion related reaction'
467	ALPHAGAN P	3	1	2	'Intraocular pressure increased, Palpitations, Myalgia'
473	XANAX	33	13	20	'Respiratory arrest, Cardiac arrest, Coeliac disease'
477	ALTABAX	1	1	0	Skin discolouration
478	ALTACE	58	24	34	'Aplasia pure red cell, Pulmonary fibrosis, Hepatic encephalopathy'
481	BENICAR HCT	9	4	5	'Blood potassium decreased, Colitis, Erectile dysfunction'
483	MEVACOR	19	10	9	'Amyotrophic lateral sclerosis, Renal failure acute, Paralysis'
489	KALETRA	59	33	26	'Progressive multifocal leukoencephalopathy, Hepatic encephalopathy, Hepatic failure'
490	ALVESCO	2	2	0	'Anaphylactic reaction, Blood pressure increased'
491	ENTEREG	3	3	0	'Respiratory failure, Tachycardia, Hypotension'
492	INDERAL	41	16	25	'Intestinal infarction, Completed suicide, Grand mal convulsion'
495	AMARYL	47	26	21	'Pancreatitis acute, Hepatic necrosis, Renal failure acute'
497	AMBIEN CR	7	6	1	'Rib fracture, Loss of consciousness, Delirium'
499	LETAIRIS	37	15	22	'Acute respiratory failure, Pulmonary fibrosis, Respiratory failure'
535	AMITIZA	10	6	4	'Anaphylactic shock, Pancreatitis, Loss of consciousness'
544	CADUET	8	5	3	'Lung neoplasm malignant, Nephrolithiasis, Hearing impaired'
553	TASIGNA	19	7	12	'Acute respiratory failure, Arterial stenosis, Gangrene'
556	AUGMENTIN	55	32	23	'Anaphylactic shock, Anaphylactoid shock, Anaphylactic reaction'
569	AMRIX	1	1	0	Completed suicide
570	ELAVIL	27	15	12	'Acute respiratory distress syndrome, Disseminated intravascular coagulation, Cardiotoxicity'
588	ARIMIDEX	29	7	22	'Deafness unilateral, Retinal haemorrhage, Glaucoma'
597	ANDRODERM	5	5	0	'Haemorrhage, Anger, Aggression'
606	ANGELIQ	1	1	0	Muscle spasms
608	ERAXIS	6	6	0	'Respiratory failure, Renal failure, Renal failure acute'
638	ANTIVERT	8	5	3	'Completed suicide, Diabetes mellitus, Amnesia'
644	TAXOL	36	20	16	'Acute respiratory distress syndrome, Pancytopenia, Pulmonary toxicity'
656	APIDRA	10	4	6	'Glaucoma, Visual impairment, Visual acuity reduced'
658	ELIQUIS	6	1	5	'Hearing impaired, Acute myocardial infarction, Cardiac failure'
665	DEPACON	21	13	8	'Neuroleptic malignant syndrome, Aplasia pure red cell, Hepatic encephalopathy'
669	APOKYN	11	8	3	'Haemolytic anaemia, Hip fracture, Dementia'
674	ARAVA	62	33	29	'Aplastic anaemia, Liver transplant, Progressive multifocal leukoencephalopathy'
677	PRINZIDE	1	1	0	Completed suicide
678	GLUCOPHAGE	65	26	39	'Renal failure acute, Pancreatitis acute, Hepatitis acute'
679	PRILOSEC	33	8	25	'Renal failure acute, Oesophageal carcinoma, Adenocarcinoma'
681	PAXIL	13	7	6	'Neuroleptic malignant syndrome, Aortic stenosis, Anger'
690	EMEND	17	7	10	'Agranulocytosis, Bone marrow failure, Pancytopenia'
693	DESOGEN	10	7	3	'Epilepsy, Nephrolithiasis, Hypothyroidism'
699	APTIVUS	12	6	6	'Pancytopenia, Renal impairment, Lymphoma'
715	ARANESP	29	10	19	'Bone marrow failure, Pancytopenia, Haemolytic anaemia'
717	ARCALYST	3	3	0	'Pulmonary hypertension, Hypertension, Arthralgia'
721	ZOLOFT	36	13	23	'Neuroleptic malignant syndrome, Foetal damage, Coeliac disease'
725	BROVANA	1	1	0	Pneumonia
734	NUVIGIL	11	5	6	'Mood altered, Somnolence, Anger'
753	ARTHROTEC	5	1	4	'Haemorrhage, Angina pectoris, Hyperkalaemia'
761	ASACOL	19	12	7	'Pulmonary fibrosis, Bone marrow failure, Pancytopenia'
779	NOVOLOG	13	5	8	'Maternal drugs affecting foetus, Pancreatic carcinoma, Loss of consciousness'
792	REYATAZ	37	19	18	'Hepatitis acute, Haemolytic anaemia, Progressive multifocal leukoencephalopathy'
804	STRATTERA	13	3	10	'Anger, Muscle twitching, Accidental overdose'
807	LIPITOR	59	16	43	'Amyotrophic lateral sclerosis, Deafness, Polymyositis'
814	ATRIPLA	8	2	6	'Liver transplant, Haemolytic anaemia, Pancytopenia'
835	AVANDAMET	26	17	9	'Sudden cardiac death, Myocardial ischaemia, Aortic stenosis'
836	AVANDARYL	10	7	3	'Myocardial ischaemia, Atrial fibrillation, Coronary artery disease'
837	AVANDIA	36	20	16	'Sudden cardiac death, Cor pulmonale, Myocardial ischaemia'
839	REMERON	38	14	24	'Neuroleptic malignant syndrome, Hepatitis acute, Sudden death'
840	AVAPRO	23	6	17	'Agranulocytosis, Sudden death, Polymyositis'
849	AVONEX	68	33	35	'Pulmonary thrombosis, Thyroid cancer, Myelitis transverse'
850	AVINZA	6	5	1	'Completed suicide, Respiratory failure, Renal failure'
878	AZILECT	7	2	5	'Atrial fibrillation, Muscle spasms, Suicidal ideation'
883	AZOPT	9	8	1	'Deafness, Intraocular pressure increased, Bronchospasm'
915	COLAZAL	7	7	0	'Pancreatitis, Neutropenia, Maternal drugs affecting foetus'
921	BARACLUDE	15	11	4	'Liver transplant, Hepatitis fulminant, Haemolytic anaemia'
928	LANTUS	49	20	29	'Blindness, Blindness unilateral, Eye haemorrhage'
939	NEXAVAR	40	19	21	'Hepatic encephalopathy, Hepatitis acute, Sudden death'
942	CIPRO	50	22	28	'Deafness permanent, Intravascular haemolysis, Deafness unilateral'
989	LOTENSIN	18	7	11	'Agranulocytosis, Rhabdomyolysis, Dysphagia'
990	LOTENSIN HCT	2	2	0	'Loss of consciousness, Confusional state'
991	TREANDA	29	16	13	'Progressive multifocal leukoencephalopathy, Haemolytic anaemia, Pancytopenia'
1029	VESICARE	12	4	8	'Dementia, Atrioventricular block complete, Intraocular pressure increased'
1031	BESIVANCE	1	1	0	Hypersensitivity
1040	BETASERON	82	34	48	'Blindness transient, Blindness unilateral, Blindness'
1056	TARGRETIN	1	1	0	Renal failure acute
1067	PRADAXA	26	9	17	'Intestinal infarction, Acute respiratory failure, Renal failure acute'
1069	CASODEX	33	18	15	'Aplastic anaemia, Disseminated intravascular coagulation, Torsade de pointes'
1081	LUMIGAN	7	3	4	'Retinal detachment, Intraocular pressure increased, Skin discolouration'
1101	EPIVIR	97	56	41	'Liver transplant, Hepatic encephalopathy, Hepatic failure'
1117	MICARDIS	22	11	11	'Hepatitis acute, Sudden death, Large intestine carcinoma'
1118	VIRAMUNE	43	22	21	'Liver transplant, Pancreatitis acute, Pancreatitis'
1120	VOLTAREN XR	4	3	1	'Respiratory failure, Cardiac arrest, Loss of consciousness'
1122	LAMICTAL	26	11	15	'Neuroleptic malignant syndrome, Maternal drugs affecting foetus, Drug-induced liver injury'
1126	VELCADE	47	31	16	'Intestinal infarction, Pancytopenia, Bone marrow failure'
1129	CELEBREX	29	4	25	'Cardiovascular disorder, Candidiasis, Connective tissue disorder'
1135	TRUVADA	32	14	18	'Stevens-Johnson syndrome, Haemolytic anaemia, Agranulocytosis'
1136	INSPRA	19	7	12	'Sudden death, Renal failure acute, Renal failure'
1138	TOVIAZ	6	3	3	'Dementia, Hearing impaired, Dysphagia'
1139	BONIVA	35	16	19	'Hip fracture, Spinal fracture, Spinal compression fracture'
1143	SELZENTRY	8	5	3	'Renal failure acute, Hodgkin's disease, Colon cancer'
1145	XOLAIR	27	11	16	'Acute respiratory failure, Lower respiratory tract infection, Aspergillosis'
1146	TAMIFLU	41	15	26	'Acute respiratory distress syndrome, Respiratory failure, Sudden death'
1151	LUCENTIS	37	21	16	'Sudden hearing loss, Optic ischaemic neuropathy, Deafness'
1152	RITUXAN	77	35	42	'Agranulocytosis, Pulmonary fibrosis, Acute respiratory failure'
1155	SUTENT	17	6	11	'Bone marrow failure, Hepatic encephalopathy, Sudden death'
1156	VIREAD	39	24	15	'Hepatic encephalopathy, Progressive multifocal leukoencephalopathy, Hepatic failure'
1158	PREMPRO	3	2	1	'Adenocarcinoma, Coeliac disease, Non-Hodgkin's lymphoma'
1163	CHANTIX	7	3	4	'Anger, Candidiasis, Restlessness'
1165	GEODON	14	5	9	'Aggression, Hallucination, Abnormal behaviour'
1170	COUMADIN	23	8	15	'Intestinal infarction, Gangrene, Ischaemic stroke'
1172	LEXAPRO	30	14	16	'Deafness unilateral, Sudden death, Maternal drugs affecting foetus'
1173	YERVOY	29	11	18	'Acute respiratory failure, Cardiopulmonary failure, Cerebral haemorrhage'
1175	ONGLYZA	11	2	9	'Pancreatic carcinoma, Cholelithiasis, Renal failure acute'
1177	SIMPONI	20	2	18	'Nephrolithiasis, Colitis, Acute respiratory distress syndrome'
1178	REMICADE	44	9	35	'Amyotrophic lateral sclerosis, Acute respiratory distress syndrome, Sudden hearing loss'
1181	INVEGA	7	6	1	'Delirium, Aggression, Accidental exposure to product'
1182	RISPERDAL	36	13	23	'Serotonin syndrome, Self injurious behaviour, Intentional self-injury'
1183	NUCYNTA	14	8	6	'Delirium, Loss of consciousness, Electrocardiogram QT prolonged'
1195	VICTRELIS	36	10	26	'Hepatic encephalopathy, Liver transplant, Deafness unilateral'
1207	ZYBAN	18	6	12	'Sudden death, Left ventricular failure, Dermatitis bullous'
1209	TRACLEER	55	30	25	'Pulmonary fibrosis, Respiratory failure, Acute respiratory failure'
1211	BOTOX	4	4	0	'Deafness unilateral, Paralysis, Accidental exposure'
1260	BYETTA	12	6	6	'Adenocarcinoma pancreas, Pancreatic carcinoma, Thyroid cancer'
1273	WELLBUTRIN	22	9	13	'Serotonin syndrome, Cardiotoxicity, Angle closure glaucoma'
1274	SYMBICORT	26	8	18	'Lung neoplasm malignant, Neoplasm malignant, Pulmonary thrombosis'
1298	BYSTOLIC	17	9	8	'Pulmonary fibrosis, Cardiac failure, Hyperkalaemia'
1306	PARAPLATIN	53	29	24	'Pancytopenia, Progressive multifocal leukoencephalopathy, Acute respiratory distress syndrome'
1313	CIALIS	17	9	8	'Prostate cancer, Retinal detachment, Retinal haemorrhage'
1382	ZOLINZA	33	25	8	'Respiratory failure, Pancytopenia, Acute respiratory distress syndrome'
1386	XELODA	28	11	17	'Intestinal infarction, Haemolytic anaemia, Small intestinal perforation'
1394	QUTENZA	1	1	0	Hypersensitivity
1403	CARBATROL	2	2	0	'Loss of consciousness, Tremor'
1409	STALEVO	35	20	15	'Acute respiratory failure, Sudden death, Hip fracture'
1441	CATAFLAM	5	4	1	'Loss of consciousness, Cardiac arrest, Hypersensitivity'
1443	CATAPRES	26	15	11	'Completed suicide, Grand mal convulsion, Respiratory depression'
1447	TORISEL	23	11	12	'Acute respiratory failure, Pulmonary fibrosis, Respiratory failure'
1450	COMBIVIR	39	21	18	'Aplastic anaemia, Pancytopenia, Haemolytic anaemia'
1453	CIMZIA	20	8	12	'Nephrolithiasis, Intestinal perforation, Large intestine perforation'
1505	CELLCEPT	26	16	10	'Acute respiratory distress syndrome, Agranulocytosis, Intestinal infarction'
1532	CEREZYME	79	46	33	'Liver transplant, Epilepsy, Respiratory failure'
1533	SANCTURA	1	1	0	Dysphagia
1617	TRILIPIX	3	2	1	'Renal impairment, Rash generalised, Blood glucose increased'
1639	ORTHO TRI-CYCLEN	5	2	3	'Coeliac disease, Hypothyroidism, Nephrolithiasis'
1646	SENSIPAR	16	6	10	'Gastric haemorrhage, Dysphagia, Muscle twitching'
1649	CINRYZE	8	7	1	'Angioedema, Staphylococcal infection, Sepsis'
1699	CLEVIPREX	1	1	0	Tachycardia
1709	CLIMARA	1	1	0	Skin discolouration
1717	CLINORIL	2	1	1	'Maternal drugs affecting foetus, Pneumonia'
1732	CLOZARIL	44	22	22	'Intestinal infarction, Burkitt's lymphoma, Phaeochromocytoma'
1734	PROZAC	46	18	28	'Neuroleptic malignant syndrome, Pulmonary fibrosis, Liver transplant'
1750	COARTEM	1	1	0	Haemolytic anaemia
1765	DIOVAN	99	46	53	'Sudden death, Haemolytic anaemia, Deafness'
1797	COMBIPATCH	7	4	3	'Haemorrhage, Osteoporosis, Tremor'
1803	TAXOTERE	44	25	19	'Intestinal infarction, Sudden death, Hepatic failure'
1822	CONCERTA	20	9	11	'Self injurious behaviour, Intentional self-injury, Suicidal ideation'
1825	PREMARIN	9	2	7	'Coeliac disease, Adenocarcinoma, Deafness'
1850	COPAXONE	20	9	11	'Amyotrophic lateral sclerosis, Paralysis, Oesophageal carcinoma'
1914	XELJANZ	2	0	2	'Muscle spasms, Swelling face'
1920	QUIXIN	14	12	2	'Disseminated intravascular coagulation, Rhabdomyolysis, Renal impairment'
1922	CREON	12	7	5	'Pancreatic carcinoma, Dermatitis bullous, Diabetes mellitus'
1928	CRESTOR	34	13	21	'Amyotrophic lateral sclerosis, Polymyositis, Coeliac disease'
1947	CUBICIN	37	18	19	'Acute respiratory distress syndrome, Acute respiratory failure, Acute hepatic failure'
1953	DEPO-PROVERA	6	4	2	'Ovarian cancer, Endometrial cancer, Mood swings'
2013	DACOGEN	14	9	5	'Respiratory failure, Haemolytic anaemia, Pulmonary fibrosis'
2055	PREZISTA	35	25	10	'Progressive multifocal leukoencephalopathy, Acute hepatic failure, Hepatic failure'
2058	SPRYCEL	13	5	8	'Acute respiratory failure, Respiratory failure, Squamous cell carcinoma'
2068	DAYPRO	4	1	3	'Dysphagia, Tremor, Arthralgia'
2095	DEFINITY	1	0	1	Infusion related reaction
2098	FIRMAGON	7	0	7	'Renal failure acute, Atrial fibrillation, Cardiac arrest'
2126	PROLIA	8	2	6	'Bone density decreased, Muscle spasms, Dementia'
2130	DEPAKOTE	19	10	9	'Neuroleptic malignant syndrome, Hepatic encephalopathy, Liver transplant'
2141	DEPODUR	1	1	0	Loss of consciousness
2145	DEPO-TESTOSTERONE	9	3	6	'Precocious puberty, Anger, Aggression'
2148	LUVOX	35	24	11	'Neuroleptic malignant syndrome, Rhabdomyolysis, Angle closure glaucoma'
2188	DESOXYN	6	5	1	'Amyotrophic lateral sclerosis, Completed suicide, Rhabdomyolysis'
2190	LEVEMIR	6	1	5	'Pancreatic carcinoma, Blindness, Hepatitis C'
2194	DEXEDRINE	3	2	1	'Agitation, Depression, Confusional state'
2202	DEXFERRUM	6	4	2	'Coma, Loss of consciousness, Infusion related reaction'
2204	FOCALIN	3	3	0	'Anger, Mental status changes, Agitation'
2260	VOLTAREN	51	28	23	'Liver transplant, Acute respiratory distress syndrome, Hepatic encephalopathy'
2265	DILAUDID	12	6	6	'Respiratory failure, Completed suicide, Delirium'
2285	TECFIDERA	10	3	7	'Memory impairment, Cognitive disorder, Muscle spasms'
2287	NATAZIA	2	2	0	'Ectopic pregnancy, Urinary tract infection'
2289	DIOVAN HCT	69	28	41	'Deafness, Cerebral infarction, Eye haemorrhage'
2322	EFFEXOR	17	6	11	'Neuroleptic malignant syndrome, Phaeochromocytoma, Hyperpyrexia'
2349	DORIBAX	12	12	0	'Septic shock, Renal impairment, Respiratory failure'
2354	TRUSOPT	6	3	3	'Bone marrow failure, Pancytopenia, Intraocular pressure increased'
2379	MULTAQ	25	10	15	'Acute hepatic failure, Hepatitis acute, Hepatic failure'
2381	YASMIN	19	7	12	'Cor pulmonale, Colitis ischaemic, Blindness unilateral'
2382	YAZ	8	3	5	'Colitis ischaemic, Nephrolithiasis, Cholelithiasis'
2393	DUAC	1	1	0	Swelling face
2414	DURAGESIC	38	7	31	'Delirium, Pancreatic carcinoma, Lung neoplasm malignant'
2444	DYSPORT	10	5	5	'Respiratory failure, Lower respiratory tract infection, Muscle twitching'
2486	EFFIENT	11	6	5	'Ventricular fibrillation, Sudden death, Colon cancer'
2496	ELAPRASE	7	3	4	'Infusion related reaction, Dysphagia, Agitation'
2500	ELESTAT	8	8	0	'Convulsion, Loss of consciousness, Hepatic function abnormal'
2501	RELPAX	11	2	9	'Colitis ischaemic, Colitis, Loss of consciousness'
2521	PROMACTA	34	14	20	'Colitis ischaemic, Hepatic failure, Haemolytic anaemia'
2526	ENBREL	11	2	9	'Arthralgia, Musculoskeletal pain, Pulmonary fibrosis'
2570	FUZEON	13	6	7	'Hepatic failure, Hodgkin's disease, Lymphoma'
2613	EPOGEN	23	12	11	'Bone marrow failure, Blindness transient, Haemolytic anaemia'
2624	EPZICOM	20	12	8	'Renal impairment, Pancytopenia, Drug reaction with eosinophilia and systemic symptoms'
2690	ESTRACE	4	2	2	'Colitis ischaemic, Liver injury, Cholelithiasis'
2694	VIVELLE	7	2	5	'Skin discolouration, Osteoporosis, Haemorrhage'
2703	ESTRING	2	0	2	'Haemorrhage, Infection'
2735	LODINE	7	4	3	'Aplastic anaemia, Drug eruption, Blood pressure decreased'
2737	NEXPLANON	3	2	1	'Mood swings, Mood altered, Accidental exposure to product'
2740	INTELENCE	6	3	3	'Pancytopenia, Lactic acidosis, Liver disorder'
2756	LEVOXYL	16	7	9	'Coeliac disease, Mental impairment, Mood altered'
2760	EVISTA	58	34	24	'Blindness unilateral, Optic ischaemic neuropathy, Colitis ischaemic'
2767	ORTHO EVRA	2	2	0	'Ectopic pregnancy, Skin discolouration'
2777	EXFORGE	47	21	26	'Deafness, Eye haemorrhage, Cerebrovascular accident'
2788	EXTAVIA	33	21	12	'Blindness, Paralysis, Mental impairment'
2798	ZETIA	22	4	18	'Amyotrophic lateral sclerosis, Muscle spasms, Tendon disorder'
2805	ZYPREXA	44	13	31	'Pancreatic necrosis, Intestinal infarction, Cor pulmonale'
2808	FABRAZYME	26	15	11	'Sudden hearing loss, Deafness unilateral, Deafness neurosensory'
2818	FARESTON	5	4	1	'Respiratory failure, Cardiac arrest, Hepatic steatosis'
2834	FAZACLO	6	5	1	'Acute respiratory failure, Respiratory failure, Completed suicide'
2837	ULORIC	8	5	3	'Toxic epidermal necrolysis, Renal impairment, Cardiac failure'
2844	FELDENE	14	8	6	'Colitis ischaemic, Bone marrow failure, Maternal drugs affecting foetus'
2871	FENTORA	2	1	1	'Neoplasm malignant, Tremor'
2873	VENOFER	16	6	10	'Haemolysis, Infusion related reaction, Venous thrombosis'
2912	FLECTOR	5	0	5	'Angina pectoris, Hypersensitivity, Musculoskeletal pain'
2978	FLUORESCITE	15	10	5	'Loss of consciousness, Respiratory arrest, Angioedema'
3010	PLAN B	4	1	3	'Mood altered, Haemorrhage, Muscle spasms'
3015	FORADIL	14	9	5	'Respiratory failure, Lung neoplasm malignant, Glaucoma'
3030	FORTAMET	2	2	0	'Renal failure acute, Renal failure'
3033	FORTEO	94	34	60	'Sudden hearing loss, Spinal fracture, Hip fracture'
3040	LEXIVA	15	7	8	'Rhabdomyolysis, Drug reaction with eosinophilia and systemic symptoms, Drug rash with eosinophilia and systemic symptoms'
3075	GILENYA	41	14	27	'Progressive multifocal leukoencephalopathy, Basal cell carcinoma, Malignant melanoma'
3102	MULTIHANCE	6	3	3	'Depressed level of consciousness, Cardiac arrest, Bronchospasm'
3103	OMNISCAN	9	6	3	'Liver transplant, Pulmonary fibrosis, Sepsis'
3106	PROHANCE	5	3	2	'Coma, Bronchospasm, Skin discolouration'
3107	GADAVIST	1	0	1	Respiratory failure
3169	MS CONTIN	18	9	9	'Respiratory failure, Hypoventilation, Neoplasm malignant'
3170	HALDOL	40	18	22	'Serotonin syndrome, Completed suicide, Hepatitis acute'
3179	VIMOVO	7	2	5	'Musculoskeletal pain, Palpitations, Diabetes mellitus'
3185	OXYCONTIN	34	13	21	'Completed suicide, Neoplasm malignant, Delirium'
3190	RITALIN	37	20	17	'Aplastic anaemia, Serotonin syndrome, Completed suicide'
3193	ZOCOR	62	20	42	'Amyotrophic lateral sclerosis, Pancreatic necrosis, Pulmonary fibrosis'
3195	SYNTHROID	22	5	17	'Coeliac disease, Candidiasis, Mood swings'
3200	ZESTRIL	6	1	5	'Lactic acidosis, Pancytopenia, Coma'
3247	GLUCOVANCE	8	4	4	'Vision blurred, Asthenia, Tremor'
3325	HALFLYTELY AND BISACODYL	8	8	0	'Loss of consciousness, Haemorrhage, Muscle spasms'
3352	HERCEPTIN	34	11	23	'Colitis ischaemic, Deafness, Hepatic failure'
3444	HYCAMTIN	46	27	19	'Agranulocytosis, Pulmonary fibrosis, Sudden death'
3521	NEOPROFEN	2	2	0	'Pulmonary hypertension, Completed suicide'
3534	IFEX	5	5	0	'Hyperpyrexia, Blood magnesium decreased, Accidental exposure'
3545	VENTAVIS	22	9	13	'Liver transplant, Acute respiratory failure, Sudden death'
3570	IMPLANON	6	2	4	'Mood swings, Mood altered, Suicidal ideation'
3576	INCRELEX	2	1	1	'Aggression, Loss of consciousness'
3577	ARCAPTA	21	15	6	'Pulmonary fibrosis, Respiratory failure, Sudden death'
3585	INDOCIN	20	12	8	'Acute respiratory distress syndrome, Serotonin syndrome, Maternal drugs affecting foetus'
3593	INFED	8	6	2	'Coma, Loss of consciousness, Infusion related reaction'
3605	REMODULIN	5	1	4	'Staphylococcal infection, Respiratory failure, Pneumonia'
3628	ROFERON A	13	9	4	'Pulmonary fibrosis, Agranulocytosis, Malignant melanoma'
3639	INVIRASE	23	16	7	'Hepatic failure, Maternal drugs affecting foetus, Lactic acidosis'
3675	ISENTRESS	48	23	25	'Haemolytic anaemia, Progressive multifocal leukoencephalopathy, Hepatic encephalopathy'
3726	JANUMET	18	8	10	'Adenocarcinoma pancreas, Pancreatic carcinoma, Colon cancer'
3727	JANUVIA	17	5	12	'Pancreatic carcinoma, Adenocarcinoma pancreas, Drug-induced liver injury'
3741	KADIAN	8	5	3	'Completed suicide, Cardiac arrest, Delirium'
3748	DEXILANT	3	2	1	'Loss of consciousness, Haemorrhage, Hypotension'
3770	KEPPRA	35	16	19	'Aplastic anaemia, Agranulocytosis, Sudden death'
3778	KETEK	37	13	24	'Hepatic encephalopathy, Acute respiratory distress syndrome, Stevens-Johnson syndrome'
3782	TORADOL	10	4	6	'Respiratory failure, Paralysis, Nephrolithiasis'
3815	KYTRIL	14	10	4	'Serotonin syndrome, Bone marrow failure, Hepatic failure'
3820	VIMPAT	22	9	13	'Acute hepatic failure, Sudden death, Toxic epidermal necrolysis'
3837	TYKERB	26	9	17	'Cardiotoxicity, Cardiopulmonary failure, Pulmonary thrombosis'
3849	LATISSE	6	3	3	'Eye haemorrhage, Muscle twitching, Intraocular pressure increased'
3853	LEVITRA	5	2	3	'Eye haemorrhage, Retinal detachment, Ventricular fibrillation'
3859	TYZEKA	13	10	3	'Hepatic failure, Renal impairment, Renal failure acute'
3890	XYZAL	15	12	3	'Maternal drugs affecting foetus, Loss of consciousness, Erythema multiforme'
3893	MIRENA	5	3	2	'Sudden hearing loss, Endometrial cancer, Penile pain'
3898	LEXISCAN	5	4	1	'Loss of consciousness, Extravasation, Bronchospasm'
3928	PRAVACHOL	34	17	17	'Amyotrophic lateral sclerosis, Pulmonary fibrosis, Hepatic necrosis'
3945	PRINIVIL	15	3	12	'Pancreatic necrosis, Completed suicide, Lactic acidosis'
3955	LIVALO	7	1	6	'Musculoskeletal pain, Diabetes mellitus, Chest pain'
4005	LOVAZA	14	3	11	'Pancreatitis acute, Angina unstable, Dysphagia'
4061	MAGNEVIST	18	7	11	'Pulmonary fibrosis, Depressed level of consciousness, Skin discolouration'
4082	MARINOL	4	4	0	'Pneumonia, Urinary tract infection, Tremor'
4085	TYSABRI	21	6	15	'Myelitis transverse, Cognitive disorder, Ankle fracture'
4096	REGLAN	8	2	6	'Phaeochromocytoma, Muscle twitching, Serotonin syndrome'
4132	MOBIC	22	10	12	'Aplastic anaemia, Haemolytic anaemia, Haemorrhage'
4163	METADATE	2	2	0	'Muscle twitching, Anger'
4182	MIRCERA	9	3	6	'Sudden death, Renal impairment, Hyperkalaemia'
4219	PROMETRIUM	4	3	1	'Maternal drugs affecting foetus, Pharyngeal oedema, Palpitations'
4233	ZAVESCA	12	11	1	'Epilepsy, Convulsion, Respiratory failure'
4238	SAVELLA	13	3	10	'Mood altered, Mood swings, Pharyngeal oedema'
4309	MONOPRIL	5	2	3	'Renal impairment, Dermatitis bullous, Rhabdomyolysis'
4310	MONOPRIL-HCT	3	2	1	'Rhabdomyolysis, Hypocalcaemia, Drug rash with eosinophilia and systemic symptoms'
4331	MOVIPREP	3	3	0	'Blood pressure decreased, Dysphagia, Muscle spasms'
4333	NOXAFIL	13	10	3	'Septic shock, Pancytopenia, Pancreatitis'
4336	MOZOBIL	21	18	3	'Bone marrow failure, Respiratory failure, Septic shock'
4337	MYOZYME/LUMIZYME	18	15	3	'Sudden death, Acute respiratory distress syndrome, Septic shock'
4369	MYFORTIC	21	6	15	'Pancytopenia, Bone marrow failure, Respiratory failure'
4386	RELAFEN	7	3	4	'Haemorrhage, Skin discolouration, Hepatitis'
4391	NAMENDA	48	18	30	'Dementia, Delirium, Atrioventricular block complete'
4401	REVIA	7	4	3	'Delirium, Abnormal behaviour, Amnesia'
4434	STARLIX	40	18	22	'Sudden death, Pancreatitis acute, Renal impairment'
4464	NEORAL	58	36	22	'Aplastic anaemia, Haemolytic anaemia, Liver transplant'
4474	NEUPRO	21	7	14	'Sudden death, Hip fracture, Femur fracture'
4490	NIASPAN	2	0	2	'Coeliac disease, Muscle spasms'
4541	NORCO	3	3	0	'Loss of consciousness, Confusional state, Depression'
4566	NOVOLOG MIX	13	6	7	'Sudden death, Loss of consciousness, Acute myocardial infarction'
4574	NPLATE	44	24	20	'Aplastic anaemia, Acute respiratory failure, Pancytopenia'
4584	NUVARING	40	16	24	'Ectopic pregnancy, Nephrolithiasis, Right ventricular failure'
4593	OCTAGAM	3	3	0	'Neutropenia, Infusion related reaction, Confusional state'
4609	SYMBYAX	2	1	1	'Diabetes mellitus, Myocardial infarction'
4621	ZOFRAN	51	27	24	'Serotonin syndrome, Colitis ischaemic, Hepatitis acute'
4631	OPTIMARK	28	26	2	'Respiratory failure, Renal failure, Carotid artery stenosis'
4658	ORUDIS	13	4	9	'Colitis ischaemic, Colitis, Hepatic steatosis'
4664	OSMOPREP	10	9	1	'Myocardial infarction, Blood potassium decreased, Tremor'
4678	TRILEPTAL	38	18	20	'Sudden death, Dermatitis bullous, Atrioventricular block complete'
4710	VECTIBIX	42	23	19	'Neutropenia, Disseminated intravascular coagulation, Pancytopenia'
4740	VOTRIENT	14	2	12	'Retinal detachment, Hypocalcaemia, Hepatic failure'
4744	PEG-INTRON	50	19	31	'Liver transplant, Hepatic encephalopathy, Pulmonary fibrosis'
4745	PEGASYS	48	17	31	'Hepatic encephalopathy, Liver transplant, Pulmonary fibrosis'
4764	PENTASA	14	7	7	'Maternal drugs affecting foetus, Nephrolithiasis, Pneumonia'
4800	PERJETA	4	4	0	'Renal failure acute, Pulmonary embolism, Pneumonia'
4907	PREMPHASE	1	0	1	Haemorrhage
4929	PROAIR HFA	1	0	1	Palpitations
4938	PROCRIT	25	7	18	'Bone marrow failure, Liver transplant, Haemolytic anaemia'
4961	RYTHMOL	20	10	10	'Completed suicide, Cardiotoxicity, Loss of consciousness'
5023	SEROQUEL	13	3	10	'Serotonin syndrome, Anger, Mood swings'
5046	ROZEREM	6	1	5	'Restlessness, Serotonin syndrome, Mental impairment'
5049	RANEXA	17	11	6	'Torsade de pointes, Sudden death, Rhabdomyolysis'
5053	RAPAFLO	7	4	3	'Loss of consciousness, Erectile dysfunction, Swelling face'
5079	RELISTOR	2	2	0	'Tachycardia, Chest pain'
5095	RENVELA	1	1	0	Cardiac arrest
5108	RESTASIS	5	3	2	'Conjunctival haemorrhage, Eye haemorrhage, Intraocular pressure increased'
5116	VIAGRA	16	9	7	'Sudden death, Prostate cancer, Retinal detachment'
5121	RHEUMATREX	14	10	4	'Pulmonary fibrosis, Acute respiratory distress syndrome, Renal impairment'
5140	XIFAXAN	5	5	0	'Hepatic failure, Renal failure acute, Renal failure'
5154	RISPERDAL CONSTA	19	6	13	'Delirium, Cytolytic hepatitis, Aggression'
5158	XARELTO	18	4	14	'Acute hepatic failure, Renal impairment, Hepatitis acute'
5181	REQUIP XL	7	4	3	'Dementia, Restlessness, Aggression'
5184	ROWASA	3	3	0	'Maternal drugs affecting foetus, Haemorrhage, Myalgia'
5196	SABRIL	3	0	3	'Respiratory arrest, Anger, Agitation'
5207	SEREVENT	8	4	4	'Sudden death, Respiratory failure, Respiratory arrest'
5215	SANDOSTATIN	25	12	13	'Septic shock, Hepatic failure, Disseminated intravascular coagulation'
5271	SIMCOR	1	0	1	Musculoskeletal pain
5309	SOLIRIS	29	5	24	'Aplastic anaemia, Basal cell carcinoma, Haemoglobinuria'
5322	SOMATULINE DEPOT	12	5	7	'Neoplasm malignant, Loss of consciousness, Liver disorder'
5323	SOMAVERT	4	2	2	'Cholelithiasis, Hepatitis, Pulmonary embolism'
5337	SPIRIVA	6	2	4	'Cor pulmonale, Lung neoplasm malignant, Acute respiratory failure'
5349	ZERIT	68	44	24	'Progressive multifocal leukoencephalopathy, Hepatic necrosis, Hepatic encephalopathy'
5415	VYTORIN	32	18	14	'Hepatic necrosis, Blindness unilateral, Polymyositis'
5442	TACLONEX	2	2	0	'Adrenal insufficiency, Dermatitis exfoliative'
5482	XENAZINE	10	6	4	'Dementia, Aggression, Anger'
5487	EFFEXOR XR	12	6	6	'Phaeochromocytoma, Cardiotoxicity, Coeliac disease'
5488	THALOMID	29	9	20	'Intestinal infarction, Respiratory failure, Sudden death'
5515	LEVOTHYROXINE	23	10	13	'Completed suicide, Basedow's disease, Dermatitis bullous'
5527	TYGACIL	11	5	6	'Disseminated intravascular coagulation, Encephalopathy, Infusion related reaction'
5546	ACTEMRA	49	23	26	'Colitis ischaemic, Disseminated intravascular coagulation, Acute respiratory failure'
5574	TRAVATAN	5	3	2	'Retinal haemorrhage, Intraocular pressure increased, Arrhythmia'
5581	TREXIMET	1	1	0	Musculoskeletal pain
5629	TRIZIVIR	20	12	8	'Pancytopenia, Drug rash with eosinophilia and systemic symptoms, Maternal drugs affecting foetus'
5679	ONFI	7	2	5	'Maternal drugs affecting foetus, Anger, Coma'
5700	VAGIFEM	1	1	0	Atrial fibrillation
5703	EXFORGE HCT	6	4	2	'Coronary artery occlusion, Cerebrovascular accident, Cholelithiasis'
5704	VALTREX	38	15	23	'Renal impairment, Agranulocytosis, Deafness'
5716	CAPRELSA	11	6	5	'Angina pectoris, Pulmonary embolism, Cholelithiasis'
5745	VERAMYST	7	5	2	'Eye haemorrhage, Intraocular pressure increased, Bronchospasm'
5753	VERSED	48	28	20	'Ventricular fibrillation, Toxic epidermal necrolysis, Hepatic encephalopathy'
5763	VIGAMOX	2	2	0	'Retinal detachment, Intraocular pressure increased'
5766	ONCOVIN	86	64	22	'Bone marrow failure, Pancytopenia, Hepatitis fulminant'
5774	VISICOL	8	6	2	'Depressed level of consciousness, Colitis, Blood pressure decreased'
5793	VIVITROL	2	1	1	'Loss of consciousness, Tremor'
5811	WELLBUTRIN XL	4	2	2	'Anger, Accidental overdose, Serotonin syndrome'
5842	XYREM	58	34	24	'Pulmonary thrombosis, Spinal fracture, Paralysis'
5858	ZEMAIRA	2	2	0	'Respiratory failure, Infusion related reaction'
5859	ZEMPLAR	24	13	11	'Gangrene, Aortic stenosis, Acute myocardial infarction'
5860	ZEMURON	15	9	6	'Acute respiratory distress syndrome, Rhabdomyolysis, Respiratory failure'
5866	ZESTORETIC	2	2	0	'Rhabdomyolysis, Loss of consciousness'
5878	ZOMIG	11	2	9	'Epilepsy, Coeliac disease, Grand mal convulsion'
5900	ZYLOPRIM	8	6	2	'Drug rash with eosinophilia and systemic symptoms, Sepsis, Cardiac failure'
5905	AMPYRA	43	21	22	'Nephrolithiasis, Loss of consciousness, Paralysis'
5906	ARZERRA	8	3	5	'Respiratory failure, Renal failure acute, Hypokalaemia'
5911	COLCRYS	2	2	0	'Renal failure acute, Maternal drugs affecting foetus'
5912	EMBEDA	2	2	0	'Hypersensitivity, Agitation'
5913	FANAPT	8	5	3	'Loss of consciousness, Swollen tongue, Muscle twitching'
5914	FERAHEME	19	12	7	'Acute respiratory failure, Acute myocardial infarction, Cardiac arrest'
5915	FOLOTYN	3	3	0	'Renal failure acute, Pneumonia, Hypotension'
5917	ONSOLIS	1	1	0	Neoplasm malignant
5919	PENNSAID	1	1	0	Renal failure
5921	PROVENGE	25	19	6	'Renal failure acute, Pancytopenia, Acute myocardial infarction'
5922	SAPHRIS	7	3	4	'Muscle twitching, Agitation, Anger'
5923	STELARA	13	3	10	'Type 2 diabetes mellitus, Dermatitis exfoliative, Hepatic steatosis'
5925	VIBATIV	1	1	0	Thrombocytopenia
5926	VICTOZA	6	3	3	'Adenocarcinoma pancreas, Pancreatic carcinoma, Cholelithiasis'
5933	BOSULIF	3	3	0	'Atrial fibrillation, Cardiac failure congestive, Dysphagia'
5979	DULERA	5	2	3	'Muscle spasms, Aggression, Palpitations'
5981	JALYN	3	1	2	'Loss of consciousness, Muscle spasms, Myalgia'
5987	HALAVEN	7	7	0	'Acute respiratory failure, Bone marrow failure, Respiratory failure'
5992	INTUNIV	6	6	0	'Pancreatitis, Suicidal ideation, Loss of consciousness'
5993	JEVTANA	10	8	2	'Disseminated intravascular coagulation, Pancytopenia, Sudden death'
6012	SERAX	24	16	8	'Toxic epidermal necrolysis, Completed suicide, Respiratory failure'
6066	VPRIV	1	1	0	Infusion related reaction
6118	POMALYST	6	5	1	'Pancytopenia, Bone marrow failure, Atrial flutter'
6122	SIGNIFOR	1	1	0	Urinary tract infection
6150	NESINA	6	4	2	'Pancreatic carcinoma, Cerebral infarction, Cardiac failure'
6156	STIVARGA	9	4	5	'Delirium, Skin discolouration, Swollen tongue'
6184	FERRIPROX	1	1	0	Asthenia
6297	WELLBUTRIN SR	10	4	6	'Mental impairment, Anger, Drug eruption'
6301	INCIVEK	31	14	17	'Hepatic encephalopathy, Neutropenia, Renal impairment'
6306	DALIRESP	20	5	15	'Respiratory failure, Pneumonia, Gynaecomastia'
6308	BEYAZ	5	4	1	'Coeliac disease, Mood altered, Mood swings'
6309	XGEVA	10	5	5	'Hypomagnesaemia, Blood potassium increased, Musculoskeletal pain'
6315	PLAQUENIL	47	26	21	'Torsade de pointes, Toxic epidermal necrolysis, Progressive multifocal leukoencephalopathy'
6317	EGRIFTA	7	3	4	'Nephrolithiasis, Gynaecomastia, Tendonitis'
6350	KOMBIGLYZE XR	5	0	5	'Dysphagia, Vision blurred, Muscle spasms'
6351	LATUDA	4	3	1	'Anaphylactic reaction, Hallucination, Hypersensitivity'
6352	TRADJENTA	11	2	9	'Pancreatic carcinoma, Drug eruption, Renal impairment'
6394	ADRIAMYCIN	25	18	7	'Progressive multifocal leukoencephalopathy, Hepatic encephalopathy, Pulmonary fibrosis'
6475	TYVASO	13	8	5	'Acute respiratory failure, Respiratory failure, Sudden death'
6514	REVATIO	15	8	7	'Pulmonary fibrosis, Acute respiratory failure, Respiratory failure'
6597	EPIVIR-HBV	14	12	2	'Hepatic encephalopathy, Liver transplant, Hepatic failure'
6611	MAKENA	1	1	0	Maternal drugs affecting foetus
6620	EDARBI	2	2	0	'Cardiac failure, Loss of consciousness'
6623	BENLYSTA	20	9	11	'Arthralgia, Skin discolouration, Bone pain'
6626	POTIGA	7	4	3	'Aggression, Cognitive disorder, Abnormal behaviour'
6645	BRILINTA	11	5	6	'Ventricular fibrillation, Cardiac arrest, Drug eruption'
6648	LASTACAFT	5	5	0	'Swelling face, Hypersensitivity, Visual acuity reduced'
6649	KRYSTEXXA	2	2	0	'Cardiac arrest, Cerebrovascular accident'
6659	GLASSIA	2	2	0	'Pneumonia, Infusion related reaction'
6729	ADCETRIS	33	29	4	'Acute respiratory distress syndrome, Respiratory failure, Bone marrow failure'
6734	KYPROLIS	12	10	2	'Pancytopenia, Respiratory failure, Atrial fibrillation'
6775	CYTOXAN	1	1	0	Pancytopenia
6776	REQUIP	8	3	5	'Pulmonary fibrosis, Restlessness, Abnormal behaviour'
6777	SANDOSTATIN LAR	29	13	16	'Nephrolithiasis, Intestinal perforation, Rib fracture'
6783	DEPAKENE	38	21	17	'Hepatic necrosis, Liver transplant, Hepatic encephalopathy'
6799	METHOTREXATE	72	36	36	'Pulmonary fibrosis, Progressive multifocal leukoencephalopathy, Acute respiratory distress syndrome'
6813	XALKORI	7	3	4	'Cytolytic hepatitis, Dysphagia, Hepatitis'
6820	KEPPRA XR	1	1	0	Cerebrovascular accident
6821	ZELBORAF	24	9	15	'Epilepsy, Cerebral haemorrhage, Intestinal perforation'
6822	VIIBRYD	13	3	10	'Muscle twitching, Anger, Mood altered'
6852	HORIZANT	1	1	0	Hallucination
6869	FIRAZYR	1	1	0	Loss of consciousness
6895	GRALISE	1	1	0	Loss of consciousness
6900	KADCYLA	2	1	1	'Sepsis, Pneumonia'
6994	DOXORUBICIN	18	14	4	'Progressive multifocal leukoencephalopathy, Hepatic encephalopathy, Pancytopenia'
6996	LOESTRIN	9	7	2	'Suicidal ideation, Haemorrhage, Mood swings'
6997	LO LOESTRIN FE	2	2	0	'Haemorrhage, Muscle spasms'
7005	CLIMARA PRO	2	1	1	'Mood swings, Palpitations'
7024	JAKAFI	24	14	10	'Pancytopenia, Acute respiratory distress syndrome, Respiratory failure'
7029	EYLEA	4	3	1	'Sudden death, Dementia, Neoplasm malignant'
7030	BYDUREON	3	1	2	'Pancreatic carcinoma, Rash generalised, Cholelithiasis'
7031	ERIVEDGE	12	8	4	'Squamous cell carcinoma, Pulmonary embolism, Atrial fibrillation'
7036	KALYDECO	3	1	2	'Staphylococcal infection, Pneumonia, Infection'
7053	ZIOPTAN	3	2	1	'Intraocular pressure increased, Hypersensitivity, Arthralgia'
7063	CYCLOSPORINE	35	28	7	'Liver transplant, Aplastic anaemia, Bone marrow failure'
7071	FOCALIN XR	4	4	0	'Suicidal ideation, Agitation, Confusional state'
7074	BUTRANS	11	5	6	'Neoplasm malignant, Delirium, Suicidal ideation'
7084	MYRBETRIQ	6	2	4	'Intraocular pressure increased, Swollen tongue, Arrhythmia'
7085	VELETRI	4	4	0	'Renal failure, Atrial fibrillation, Mental status changes'
7086	AVENTYL	7	5	2	'Delirium, Coma, Cardiac arrest'
7087	EXALGO	4	4	0	'Respiratory failure, Delirium, Loss of consciousness'
7097	ESTRADERM	29	20	9	'Deafness, Pulmonary fibrosis, Basal cell carcinoma'
7113	RITALIN LA	8	8	0	'Suicidal ideation, Loss of consciousness, Agitation'
7135	METHYLIN	2	2	0	'Completed suicide, Agitation'
7136	XANAX XR	3	3	0	'Blood pressure increased, Hypersensitivity, Hypertension'
7150	VESANOID	16	14	2	'Bone marrow failure, Pancytopenia, Neutropenia'
7152	ACCUTANE	4	3	1	'Nephrolithiasis, Anger, Abnormal behaviour'
7160	AUBAGIO	30	14	16	'Paralysis, Nephrolithiasis, Foot fracture'
7195	SOLODYN	3	3	0	'Convulsion, Loss of consciousness, Confusional state'
7205	IMURAN	31	21	10	'Aplasia pure red cell, Aplastic anaemia, Pancreatitis acute'
7221	CATAPRES-TTS	1	1	0	Skin discolouration
7226	SANCTURA XR	1	1	0	Muscle spasms
7243	ULTRAM ER	4	4	0	'Transient ischaemic attack, Loss of consciousness, Confusional state'
7253	TEGRETOL-XR	11	7	4	'Coma, Cerebral haemorrhage, Delirium'
7262	PAXIL CR	6	5	1	'Aortic stenosis, Anger, Mood swings'
7267	SEROQUEL XR	5	3	2	'Mood swings, Anger, Mood altered'
7278	FINACEA	2	2	0	'Skin discolouration, Hypersensitivity'
7320	COREG CR	1	1	0	Arrhythmia
7324	LEVOTHROID	2	2	0	'Completed suicide, Tremor'
7372	ICLUSIG	5	4	1	'Pancytopenia, Respiratory failure, Renal failure'
7587	MYORISAN	1	1	0	Anger
7633	PROLASTIN-C	8	6	2	'Sepsis, Infusion related reaction, Myalgia'
7653	XTANDI	4	1	3	'Dysphagia, Muscle twitching, Muscle spasms'
7657	TUDORZA PRESSAIR	7	3	4	'Swollen tongue, Accidental overdose, Palpitations'
7682	OMONTYS	5	5	0	'Cardiac arrest, Loss of consciousness, Vision blurred'
7683	QSYMIA	3	2	1	'Anger, Restlessness, Agitation'
7741	INVOKANA	8	2	6	'Nephrolithiasis, Atrial fibrillation, Myocardial infarction'
7756	LINZESS	3	1	2	'Accidental exposure to product, Accidental overdose, Palpitations'
7760	MINIVELLE	3	2	1	'Mood swings, Rash generalised, Palpitations'
7847	SOVALDI	5	2	3	'Accidental overdose, Visual impairment, Memory impairment'
7965	XOFIGO	1	1	0	Bone pain
7972	JUXTAPID	1	1	0	Myalgia
7988	BELVIQ	1	1	0	Arthralgia
